...###
.....#.####
.##..###...
..........#
#...@..#...
#.#..###...
..#..#....#
.##.##...##
.........#
.#.....#.
.##..###