#.######.#
.@#.......
#.#.####.#
#.#.#..#.#
#.#.##.#.#
#.#.##.#.#
#.#....#.#
#.######.#
..........
#.######.#