##########
#@#......#
#.#.####.#
#.#.#..#.#
#.#.##.#.#
#.#.##.#.#
#.#....#.#
#.######.#
#........#
##########