......##..
#..##...#.
#....@....
....#..#..
#..#...#..
..#.......
#.....#.#.
..#...#...
#...#...#.
