############
#......##..#
##..##...#.#
##....@....#
#....#..#..#
##..#...#..#
#..#.......#
##.....#...#
#..#...#...#
##...#...#.#
############
